................
.....X..........
...AlllllllB....
...hX.X..Xq.....
...h.AlllB.q....
...h.hA1Bq.q....
...h.hh.qq.q....
...hXhh*qq.q....
...h.hhIqqXqX...
...hXhh.qq.q....
...hXhh.qqXq....
.XXh.hf3bq.q....
...hXfdddbXq....
...fdddddddb....
....X....X......
................