............................
............................
......AllllllllllllllllB....
......hAllllllllllllllBq....
......hh.X....X......Xqq....
......hh....I..*......2q....
......hh..X......X...Xqq....
......hh......cdddddddbq....
......hh.*..X.qcdddddddb....
......hh......qq............
......hh.X.*..qq............
......hhX....Xqq............
......hfddd3ddbq............
......fddddddddb............
............................
............................