............................
............................
............................
........AlllllllllB.........
........hAlll1lllBq.........
........hh.......qq.........
........hh.......qq.........
........hh..X.X..qq.........
........hh.XX.XX.qq.........
........hfdddddddbq.........
........fdddddddddb.........
............................
............................
............................